---------------------X------------------------------------X-B---------------o------?------X------M------E----------X------E-------M----?--?--------------------------------------?-----B-------X--------
------M------------------------------------X--X--o-----o----X-------------------?X---o-------------------------------------------------B----B-----B----------------------------------------------E------
----X-------------o------M---------------------E---o-------------------X------------------------B------------------------?--?----B------------------------o--?----------------o-------------------------
--?E----?-----------X--B-----E------------------------------------------------B--o?----o-------E-------o----B-----------------B--oM--M-------?------------------------E-B------------------M------------
----------------------------------E--------------------M----X------------------o--o-------------------?------------M-------------------------------------------X----------------------------------------
------E---------M-----------o-------o-----------EBB--------------------------o-------------B----------------------------------------------?---M--------------------------------------M----------o-M-----
----E--------------M---M----B-----?------------?------------------------------------------X------------?--------------------------------------------M----E----?---------B---------------o---------------
----------o-BM-----------?----o----------------------------?-?------E------------X----------------------------E--------B--------oB--------B----X---------E-EB-----XB-----------o--------------------B--v
---------------o-M-------------------B------?------------------X----------------------o-----------------------------------o-----------E----------------E----------X------------------------------------f
-o?-----------------------------?-----------------------?------E----------------------------------M---------------------o----o--B---------?-----------------------E----------M------?----E-------------f
------------------------M-------B-------oX-------------------------oEB----X-oE--B--------o----?-----E------------B----------------------M-M----------X-------o---o------B---------------------------M--f
---o----------------------o--B----------X--------------M--------M-BX--------------o--o-B----o-----------------------------------------------o--M------M------o--------------------------------oM-------f
--------------------------------o--E------X-M---------------o------o-X-----ME-E---------------------X--?-----o---------------M----------------------X-------------------------------------------------Mf
-----------------E-------------o----------B--------------------o----------M-----------------M-------?----------?-------------------------------------?---------------------------?B------------o-----E-f
m--------B---------------------------o----B----------M-o------E---?--------X----?----------------------?----------------------?----------?--o--------------M----------------?---------------------X----X
XXXXXXXXXXXXXXXXXXXXXXXXXXXXXXXXXXXXXXXXXXXXXXXXXXXXXXXXXXXXXXXXXXXXXXXXXXXXXXXXXXXXXXXXXXXXXXXXXXXXXXXXXXXXXXXXXXXXXXXXXXXXXXXXXXXXXXXXXXXXXXXXXXXXXXXXXXXXXXXXXXXXXXXXXXXXXXXXXXXXXXXXXXXXXXXXXXXXXXXX
