----------?--------------------------------XX--E----------M------E-B------?---E--------------M--------------------------B--------------------------------M------------o----------------o--------------?-
-B-------------------------------------------?----------------------------------------------------o-------?----X--------------------------?-----------------E-?---------------------------------------X-
---------------B----------------------------------------------------B---------------------------------------------------------?----------E----------------------------------E-------------------B-------
---------------------------B--------------E----------------------------------M-----------?----------------?------------------B-------------------------------------------B-----------------o---?--------
------------E-------------------B------------------------------o-----------------------------B------------------o--------------------------EB-----------?--B--------------------------------------------
-------------------B-------------------?----------------------Eo---------------------M-------?------------------B------------------M--------------------------o---------------------------------------M-
-------------------------B---o-----------------E-------E--------------------------o-------------------M-------------B-------M----------------------------M---------o-------------------------o-o-----E--
------------------------o--o---------B--------o----o-------------------------------------------------B-M------------------------------------------------------E----------------B-----------------------v
---------------------?-------o----?--------------------------------------------------------------------------------------------------------B------------------------------o----------------------------f
--------------?----?----?------------------------------------------M----------------E--------?M-------------------------------M---------o-----------------------------------------?--------------------f
------------------------------------------------------------------------------------------------------------------------------?---------------------------------------------------------------M--------f
------------E----------------------o-----B------------------E-o----M--------------------------------------------------------------------------------?---?----------------------------------------------f
----B-------------B--------M---M-------------------B----------------------o--------B-----------------------------------------------------------------o-----------------------------------B-------------f
-----------------------------B----------B-------------------------------------------o--------------------------------------------------------------B---E-----------------B--------------M--------?-----f
m-------------------------------E----?------o---------------------------E-E-------------------------------------------------B-------------------------------o------------------------------------------X
XB--B---B--BB-BBB---BBBBB-B----B-BB-BB--BB-----B-B-B-----B-BB-BB-BB-BBB-BB-B-B-B---B---B-B-B--B-B----B---B---B-B---B---B--B-B-B-BBB-B-BBB---B-BB-B---B--B---B-BBBB-B-BBBB---BBBB--BBB---BBB-----B---B-BX
